12
True
4
.........
.p.....X.
...X.X.X.
.X...X...
XX.....@X
.XX.....X
.XX..X.X.
....XXXX.
