19
True
4
.......X..
.XXXXX.X..
...X.X....
.XXX.X.XX.
.....X.XX.
pXXXXXXXX@
.XX......X
.XX.X...X.
.XX.XXXXX.
..........
